    A_1 = [0, 0, 0, 0, 0, 0, 1, 0, 0]
    B_1 = [0, 0, 0, 0, 0, 0, 1, 0, 0]
    C_1 = [0, 0, 0, 0, 0, 0, 0, 0, 0]
    D_1 = [0, 0, 0, 0, 0, 0, 0, 0, 1]
    E_1 = [0, 0, 0, 0, 0, 0, 1, 0, 1]
    F_1 = [0, 0, 0, 0, 0, 0, 0, 1, 0]
    G_1 = [0, 0, 0, 0, 0, 0, 0, 1, 0]
    H_1 = [0, 0, 0, 0, 0, 0, 0, 0, 1]
    I_1 = [0, 0, 0, 0, 0, 0, 1, 0, 1]
    J_1 = [0, 0, 0, 0, 0, 0, 0, 1, 1]
    K_1 = [0, 0, 0, 0, 0, 0, 0, 1, 0]
    A_2 = [0, 0, 0, 0, 0, 0, 0, 0, 1]
    B_2 = [0, 0, 0, 0, 0, 0, 1, 1, 0]
    C_2 = [0, 0, 0, 0, 0, 0, 0, 1, 0]
    D_2 = [0, 0, 0, 0, 0, 0, 0, 0, 1]
    E_2 = [0, 0, 0, 0, 0, 1, 1, 0, 0]
    F_2 = [0, 0, 0, 0, 0, 1, 1, 1, 0]
    G_2 = [0, 0, 0, 0, 0, 0, 0, 0, 0]
    H_2 = [0, 0, 0, 0, 0, 0, 0, 0, 1]
    I_2 = [0, 0, 0, 0, 0, 1, 1, 0, 0]
    J_2 = [0, 0, 0, 0, 0, 1, 0, 1, 0]
    K_2 = [0, 0, 0, 0, 0, 1, 0, 0, 0]
    A_3 = [0, 0, 0, 0, 0, 1, 0, 0, 1]
    B_3 = [0, 0, 0, 0, 0, 1, 1, 0, 0]
    C_3 = [0, 0, 0, 0, 0, 0, 0, 1, 0]
    D_3 = [0, 0, 0, 0, 0, 0, 1, 0, 1]
    E_3 = [0, 0, 0, 0, 0, 1, 0, 0, 1]
    F_3 = [0, 0, 0, 0, 0, 0, 1, 1, 0]
    G_3 = [0, 0, 0, 0, 0, 0, 1, 1, 0]
    H_3 = [0, 0, 0, 0, 0, 0, 1, 0, 1]
    I_3 = [0, 0, 0, 0, 0, 1, 1, 0, 0]
    J_3 = [0, 0, 0, 0, 0, 0, 0, 1, 0]
    K_3 = [0, 0, 0, 0, 0, 0, 0, 0, 0]
    A_4 = [0, 0, 0, 0, 0, 0, 0, 0, 1]
    B_4 = [0, 0, 0, 0, 0, 1, 1, 0, 0]
    C_4 = [0, 0, 0, 0, 0, 0, 0, 1, 1]
    D_4 = [0, 0, 0, 0, 0, 0, 1, 0, 0]
    E_4 = [0, 0, 0, 0, 0, 1, 0, 1, 1]
    F_4 = [0, 0, 0, 0, 0, 1, 0, 0, 1]
    G_4 = [0, 0, 0, 0, 0, 0, 0, 1, 1]
    H_4 = [0, 0, 0, 0, 0, 0, 1, 1, 1]
    I_4 = [0, 0, 0, 0, 0, 1, 0, 1, 0]
    J_4 = [0, 0, 0, 0, 0, 0, 0, 1, 0]
    K_4 = [0, 0, 0, 0, 0, 0, 0, 0, 0]
    A_5 = [0, 0, 0, 0, 0, 0, 1, 0, 1]
    B_5 = [0, 0, 0, 0, 0, 1, 1, 0, 0]
    C_5 = [0, 0, 0, 0, 0, 0, 1, 1, 1]
    D_5 = [0, 0, 0, 0, 0, 1, 1, 0, 0]
    E_5 = [0, 0, 0, 0, 0, 0, 0, 1, 0]
    F_5 = [0, 0, 0, 0, 0, 1, 1, 0, 0]
    G_5 = [0, 0, 0, 0, 0, 1, 1, 0, 1]
    H_5 = [0, 0, 0, 0, 0, 1, 1, 0, 0]
    I_5 = [0, 0, 0, 0, 0, 1, 0, 1, 0]
    J_5 = [0, 0, 0, 0, 0, 0, 1, 0, 0]
    K_5 = [0, 0, 0, 0, 0, 0, 1, 0, 0]
    A_6 = [0, 0, 0, 0, 0, 0, 0, 0, 1]
    B_6 = [0, 0, 0, 0, 0, 1, 0, 1, 1]
    C_6 = [0, 0, 0, 0, 0, 0, 0, 1, 1]
    D_6 = [0, 0, 0, 0, 0, 1, 1, 1, 0]
    E_6 = [0, 0, 0, 0, 0, 0, 0, 1, 1]
    F_6 = [0, 0, 0, 0, 0, 0, 1, 0, 1]
    G_6 = [0, 0, 0, 0, 0, 0, 0, 1, 1]
    H_6 = [0, 0, 0, 0, 0, 1, 0, 1, 0]
    I_6 = [0, 0, 0, 0, 0, 0, 0, 1, 1]
    J_6 = [0, 0, 0, 0, 0, 0, 1, 0, 1]
    K_6 = [0, 0, 0, 0, 0, 0, 0, 1, 0]
    A_7 = [0, 0, 0, 0, 0, 1, 0, 0, 0]
    B_7 = [0, 0, 0, 0, 0, 1, 0, 0, 0]
    C_7 = [0, 0, 0, 0, 0, 1, 0, 0, 1]
    D_7 = [0, 0, 0, 0, 0, 1, 1, 0, 0]
    E_7 = [0, 0, 0, 0, 0, 0, 0, 1, 1]
    F_7 = [0, 0, 0, 0, 0, 1, 1, 0, 0]
    G_7 = [0, 0, 0, 0, 0, 1, 0, 1, 0]
    H_7 = [0, 0, 0, 0, 0, 1, 0, 0, 0]
    I_7 = [0, 0, 0, 0, 0, 0, 0, 0, 1]
    J_7 = [0, 0, 0, 0, 0, 1, 1, 0, 0]
    K_7 = [0, 0, 0, 0, 0, 1, 0, 1, 0]
    A_8 = [0, 0, 0, 0, 0, 0, 0, 0, 0]
    B_8 = [0, 0, 0, 0, 0, 0, 1, 0, 0]
    C_8 = [0, 0, 0, 0, 0, 0, 1, 0, 1]
    D_8 = [0, 0, 0, 0, 0, 1, 1, 0, 0]
    E_8 = [0, 0, 0, 0, 0, 0, 1, 1, 1]
    F_8 = [0, 0, 0, 0, 0, 1, 1, 0, 0]
    G_8 = [0, 0, 0, 0, 0, 0, 1, 1, 0]
    H_8 = [0, 0, 0, 0, 0, 0, 1, 0, 0]
    I_8 = [0, 0, 0, 0, 0, 0, 1, 0, 1]
    J_8 = [0, 0, 0, 0, 0, 1, 1, 0, 0]
    K_8 = [0, 0, 0, 0, 0, 0, 0, 1, 0]
    A_9 = [0, 0, 0, 0, 0, 0, 0, 0, 1]
    B_9 = [0, 0, 0, 0, 0, 0, 1, 0, 1]
    C_9 = [0, 0, 0, 0, 0, 0, 0, 1, 1]
    D_9 = [0, 0, 0, 0, 0, 1, 0, 1, 1]
    E_9 = [0, 0, 0, 0, 0, 0, 0, 1, 1]
    F_9 = [0, 0, 0, 0, 0, 1, 1, 1, 1]
    G_9 = [0, 0, 0, 0, 0, 0, 0, 1, 1]
    H_9 = [0, 0, 0, 0, 0, 0, 0, 1, 1]
    I_9 = [0, 0, 0, 0, 0, 0, 0, 1, 1]
    J_9 = [0, 0, 0, 0, 0, 1, 1, 1, 0]
    K_9 = [0, 0, 0, 0, 0, 0, 0, 1, 0]
    A_10 = [0, 0, 0, 0, 0, 0, 1, 0, 1]
    B_10 = [0, 0, 0, 0, 0, 1, 1, 0, 0]
    C_10 = [0, 0, 0, 0, 0, 1, 0, 1, 0]
    D_10 = [0, 0, 0, 0, 0, 1, 0, 0, 0]
    E_10 = [0, 0, 0, 0, 0, 1, 0, 0, 1]
    F_10 = [0, 0, 0, 0, 0, 1, 1, 0, 0]
    G_10 = [0, 0, 0, 0, 0, 1, 0, 1, 0]
    H_10 = [0, 0, 0, 0, 0, 1, 0, 0, 0]
    I_10 = [0, 0, 0, 0, 0, 1, 0, 0, 1]
    J_10 = [0, 0, 0, 0, 0, 1, 1, 0, 0]
    K_10 = [0, 0, 0, 0, 0, 0, 0, 1, 0]
    A_11 = [0, 0, 0, 0, 0, 0, 0, 0, 1]
    B_11 = [0, 0, 0, 0, 0, 1, 0, 1, 0]
    C_11 = [0, 0, 0, 0, 0, 0, 0, 1, 0]
    D_11 = [0, 0, 0, 0, 0, 0, 0, 0, 0]
    E_11 = [0, 0, 0, 0, 0, 0, 0, 0, 1]
    F_11 = [0, 0, 0, 0, 0, 1, 0, 0, 0]
    G_11 = [0, 0, 0, 0, 0, 0, 0, 1, 0]
    H_11 = [0, 0, 0, 0, 0, 0, 0, 0, 0]
    I_11 = [0, 0, 0, 0, 0, 0, 0, 0, 1]
    J_11 = [0, 0, 0, 0, 0, 1, 0, 0, 0]
    K_11 = [0, 0, 0, 0, 0, 0, 0, 1, 0]
