! = Boss
0 = Blank
+ = Empty
# = Enemy
$ = Save
@ = Entrance


0000+@00++!
++00+000+00
0+00++00+00
0+0+0+++$00
0+0+000+000
@+++0+++0+@
000+0+000+0
000+0+000+0
0++++++++$0
0+000+000+0
++000@000+0

